   ON - 1 
   UN - decrease by one 
   AN -increase by one 
   EN - conjure one 
   IN - one to put one in, one's own one
   EYEN - me (one) 
   UNE - you (one) 
   EEN - us (one) 
   unwunwun - them/those/others (one) 
   GON = infinity 
   GAN = tending to infinity 
   GUN = infinate pre-potential (morgri)
   KON = the most ones 
   KAN = the highest eater 
   you can say everything with gendered first distinctions in elven

some suggested genders, these work well, 15 years field tested :

I=the narrator, the chooser, and the questioner, power-up via data advantage/leverage
M=Goddess/mother/product/asset/sov/The Food, eatative gender
H=hair=heaven=haha, breathe, pairs with f=facing
L=loop,period,light, days repeating
O=ongoing,
U=down, -1
D=Dragon
R=Roar, big teeth
E=effect,conjure,produce,grow
A=up, apple, primary +1
S=choice/decision/split/see/science
T= teeth, eating it, tea time, tonight, tea itself.
P=Father, peen, peacocking, post, power
B=baby, ball, base, boon, treasure.
F=facing, fur, first
G=God,male, Godding, the art of
W=wavering choice/option
Y=yes, eater, eat first, ask please later, thankyou
N=no, eaten, negation as question, not in force
C=change,cast,chuck,carry over, send, chat, conversation
K=king, top, best
J=joker,wildcard, unknown, prince of jewela
X=marks the spot of kisses and negation, inedible, not eaten, negation in force
Q=Queen's choice
V = delve, cleave, entower, exponentiate
Z= the end
